WordCamp Kyoto	わーどきゃんぷきょうと	名前
WordCamp Japan	わーどきゃんぷじゃぱん	名前
WordCamp Europe	わーどきゃんぷよーろっぱ	名前
WordCamp Euro	わーどきゃんぷゆーろ	名前
WordCamp EU	わーどきゃんぷいーゆー	名前
Windows	うぃんどうず	名前
Matt Mullenweg	まっとまれんうぇっぐ	名前
WordCamp Kobe	わーどきゃんぷこうべ	名前
Automattic	おーとまてぃっく	名前
WordCamp Hongkong	わーどきゃんぷほんこん	名前
WordCamp Kansai	わーどきゃんぷかんさい	名前
WordCamp Osaka	わーどきゃんぷおおさか	名前
WordCamp Niigata	わーどきゃんぷにいがた	名前
WordCamp Ogijima	わーどきゃんぷおぎじま	名前
WordCamp Tokyo	わーどきゃんぷとうきょう	名前
WordCamp US	わーどきゃんぷゆーえす	名前
WordCamp Yokohama	わーどきゃんぷよこはま	名前
WordFes Nagoya	わーどふぇすなごや	名前
WP ZoomUP	だぶりゅぴーずーむあっぷ	名前
WP ZoomUP	だぶるぴーずーむあっぷ	名前
インクルーシブデザイン	いんるーしぶでざいん	アクセシビリティ
アニメーション	あにめーしょん	アクセシビリティ
アクセシビリティ方針	あくせしびりてぃほうしん	アクセシビリティ
VoiceOver	ぼいすおーばー	アクセシビリティ
ガイドライン	がいどらいん	アクセシビリティ
キーボードトラップ	きーぼーどとらっぷ	アクセシビリティ
キーボード操作	きーぼーどそうさ	アクセシビリティ
コントラスト	こんとらすと	アクセシビリティ
ジェスチャー	じぇすちゃー	アクセシビリティ
シンボル	しんぼる	アクセシビリティ
アクセシビリティ対応	あくせしびりてぃたいおう	アクセシビリティ
アクセシビリティ	あくせしびりてぃ	アクセシビリティ
インタラクション	いんたらくしょん	アクセシビリティ
3:1	さんたいいち	アクセシビリティ
4.5:1	よんてんごたいいち	アクセシビリティ
7:1	ななたいいち	アクセシビリティ
a11y	えーいれぶんわい	アクセシビリティ
JIS	じす	アクセシビリティ
JIS X 8341-3	じすえっくすはちさんよんいちのさん	アクセシビリティ
lang属性	らんぐぞくせい	アクセシビリティ
WAI-ARIA	うぇいありあ	アクセシビリティ
知覚	ちかく	アクセシビリティ
タイミング	たいみんぐ	アクセシビリティ
ズーム	ずーむ	アクセシビリティ
知覚可能	ちかくかのう	アクセシビリティ
達成基準	たっせいきじゅん	アクセシビリティ
代替テキスト	だいたいてきすと	アクセシビリティ
代替コンテンツ	だいたいこんてんつ	アクセシビリティ
対象地域	たいしょうちいき	アクセシビリティ
操作可能	そうさかのう	アクセシビリティ
障害者対応	しょうがいしゃたいおう	アクセシビリティ
非テキストコンテンツ	ひてきすとこんてんつ	アクセシビリティ
入力	にゅうりょく	アクセシビリティ
入力支援	にゅうりょくしえん	アクセシビリティ
閾値	しきいち	アクセシビリティ
閾値	いきち	アクセシビリティ
略語	りゃくご	アクセシビリティ
予測	よそく	アクセシビリティ
品質	ひんしつ	アクセシビリティ
発話	はつわ	アクセシビリティ
背景音	はいけいおん	アクセシビリティ
入力欄	にゅうりょくらん	アクセシビリティ
識字率	しきじりつ	アクセシビリティ
字幕	じまく	アクセシビリティ
パーマネント	ぱーまねんと	アクセシビリティ
拡大印刷	かくだいいんさつ	アクセシビリティ
回避策	かいひさく	アクセシビリティ
音声認識API	おんせいにんしきえーぴーあい	アクセシビリティ
ラベル	らべる	アクセシビリティ
ユーザビリティ	ゆーざびりてぃ	アクセシビリティ
マシンリーダブル	ましんりーだぶる	アクセシビリティ
マシンリーダビリティ	ましんりーだびりてぃ	アクセシビリティ
マシンアクセシビリティ	ましんあくせしびりてぃ	アクセシビリティ
ポインタ	ぽいんた	アクセシビリティ
ブロックスキップ	ぶろっくすきっぷ	アクセシビリティ
プレースホルダー	ぷれーすほるだー	アクセシビリティ
フォーカス順序	ふぉーかすじゅんじょ	アクセシビリティ
フォーカス	ふぉーかす	アクセシビリティ
ヒューマンユーザビリティ	ひゅーまんゆーざびりてぃ	アクセシビリティ
健常者	けんじょうしゃ	アクセシビリティ
音声解説	おんせいかいせつ	アクセシビリティ
構文解析	こうぶんかいせき	アクセシビリティ
堅牢	けんろう	アクセシビリティ
支援技術	しえんぎじゅつ	アクセシビリティ
ご清聴	ごせいちょう	イベント
トレンド	とれんど	マーケティング
トラフィック	とらふぃっく	マーケティング
デモデータ	でもでーた	マーケティング
ニュースリリース	にゅーすりりーす	マーケティング
デモ	でも	マーケティング
デジタルマーケティング	でじたるまーけてぃんぐ	マーケティング
デジタルノマド	でじたるのまど	マーケティング
デザイン方針	でざいんほうしん	マーケティング
ブランディング	ぶらんでぃんぐ	マーケティング
ニュースメディア	にゅーすめでぃあ	マーケティング
ブランド価値	ぶらんどかち	マーケティング
プレスリリース	ぷれすりりーす	マーケティング
フロー	ふろー	マーケティング
ファイナンシャル・プランニング	ふぁいなんしゃるぷらんにんぐ	マーケティング
ハンズオン	はんずおん	マーケティング
パラレルキャリア	ぱられるきゃりあ	マーケティング
プロジェクター	ぷろじぇくたー	マーケティング
フォロー	ふぉろー	マーケティング
ハッカソン	はっかそん	マーケティング
チャプター	ちゃぷたー	マーケティング
フェーズ	ふぇーず	マーケティング
プロダクトマネジャー	ぷろだくとまねーじゃー	マーケティング
メルマガ	めるまが	マーケティング
ユーザーインタビュー	ゆーざーいんたびゅー	マーケティング
ユーザーインタフェース	ゆーざーいんたーふぇーす	マーケティング
ライター	らいたー	マーケティング
ライティング	らいてぃんぐ	マーケティング
リサーチ	りさーち	マーケティング
リソース	りそーす	マーケティング
リダイレクト	りだいれくと	マーケティング
リファラー	りふぁらー	マーケティング
リライト	りらいと	マーケティング
リンク構造	りんくこうぞう	マーケティング
ルート	るーと	マーケティング
メタ構文	めたこうぶん	マーケティング
マーケティング手法	まーけでぃんぐしゅほう	マーケティング
マーケティングオートメーション	まーけてぃんぐおーとめーしょん	マーケティング
プロモーション	ぷろもーしょん	マーケティング
フロントエンドエンジニア	ふろんとえんどえんじにあ	マーケティング
フロントエンドデザイン	ふろんとえんどでざいん	マーケティング
ベストプラクティス	べすとぷらくてぃす	マーケティング
ペルソナ	ぺるそな	マーケティング
ポータルサイト	ぽーたるさいと	マーケティング
ポート	ぽーと	マーケティング
ボクシルマガジン	ぼくしるまがじん	マーケティング
ポップアップ	ぽっぷあっぷ	マーケティング
ボリューム	ぼりゅーむ	マーケティング
ホワイトペーパー	ほわいとぺーぱー	マーケティング
マーケット	まーけっと	マーケティング
レコメンデーションエンジン	れこめんでーしょんえんじん	マーケティング
MA	えむえー	マーケティング
キーワードライフタイム	きーわーどらいふたいむ	マーケティング
キーワード設定	きーわーどせってい	マーケティング
キーワード戦略	きーわーどせんりゃく	マーケティング
キーワード選定	きーわーどせんてい	マーケティング
キュレーションメディア	きゅれーしょんめでぃあ	マーケティング
クーポン	くーぽん	マーケティング
コーポレートサイト	こーぽれーとさいと	マーケティング
コピーコンテンツ	こぴーこんてんつ	マーケティング
コミュニケーション	こみゅにけーしょん	マーケティング
コワーキングスペース	こわーきんぐすぺーす	マーケティング
キーワード	きーわーど	マーケティング
カスタマージャーニーマップ	かすたまーじゃーにーまっぷ	マーケティング
カスタマー	かすたまー	マーケティング
PV	ぴーぶい	マーケティング
Webライティング	うぇぶらいてぃんぐ	マーケティング
Web解析	うぇぶかいせき	マーケティング
アクセス	あくせす	マーケティング
アクティビティ	あくてぃびてぃ	マーケティング
インバウンド	いんばうんど	マーケティング
インバウンドマーケティング	いんばうんどまーけてぃんぐ	マーケティング
ウェブライター	うぇぶらいたー	マーケティング
ウェブ解析士	うぇぶかいせきし	マーケティング
オーガニックサーチ	おーがにっくさーち	マーケティング
コンサルティング	こんさるてぃんぐ	マーケティング
コンテンツ	こんてんつ	マーケティング
サブミット	さぶみっと	マーケティング
スキルセット	すきるせっと	マーケティング
ステップ	すてっぷ	マーケティング
ステップメール	すてっぷめーる	マーケティング
セールス	せーるす	マーケティング
セッション	せっしょん	マーケティング
ソーシャルマーケティング	そーしゃるまーけてぃんぐ	マーケティング
ソーシャルメディア	そーしゃるめでぃあ	マーケティング
ターゲットユーザー	たーげっとゆーざー	マーケティング
ターゲティング	たーげてぃんぐ	マーケティング
サブスクリプション	さぶすくりぷしょん	マーケティング
サブキーワード	さぶきーわーど	マーケティング
サチコ（サーチコンソール）	さちこ	マーケティング
コンテンツマーケティング	こんてんつまーけてぃんぐ	マーケティング
コンテンツリスト	こんてんつりすと	マーケティング
コンテンツ管理	こんてんつかんり	マーケティング
コンテンツ構造	こんてんつこうぞう	マーケティング
アクセス解析	あくせすかいせき	マーケティング
コンテンツ戦略	こんてんつせんりゃく	マーケティング
コンバージョン	こんばーじょん	マーケティング
サービス	さーびす	マーケティング
サイト内検索	さいとないけんさく	マーケティング
サイト保守	さいとほしゅ	マーケティング
ダイレクト	だいれくと	マーケティング
コンテンツリスト・スケジュール	こんてんつりすとすけじゅーる	マーケティング
商品連携	しょうひんれんけい	マーケティング
商品コード	しょうひんこーど	マーケティング
順位	じゅんい	マーケティング
重要度	じゅうようど	マーケティング
従量課金	じゅうりょうかきん	マーケティング
社内リソース	しゃないりそーす	マーケティング
実行	じっこう	マーケティング
自然流入	しぜんりゅうにゅう	マーケティング
自社製品	じしゃせいひん	マーケティング
自社サービス	じしゃさーびす	マーケティング
紙媒体	かみばいたい	マーケティング
施策	せさく	マーケティング
施策	しさく	マーケティング
購買行動	こうばいこうどう	マーケティング
更新頻度	こうしんひんど	マーケティング
制作進行	せいさくしんこう	マーケティング
制作単価	せいさくたんか	マーケティング
選定	せんてい	マーケティング
測定	そくてい	マーケティング
KPI	けーぴーあい	マーケティング
類似キーワード	るいじきーわーど	マーケティング
流入	りゅうにゅう	マーケティング
離脱率	りだつりつ	マーケティング
優先順位	ゆうせんじゅんい	マーケティング
目標設定	もくひょうせってい	マーケティング
編集方針	へんしゅうほうしん	マーケティング
複合的	ふくごうてき	マーケティング
販促ツール	はんそくつーる	マーケティング
反応	はんのう	マーケティング
動画編集	どうがへんしゅう	マーケティング
動画	どうが	マーケティング
定期支払い	ていきしはらい	マーケティング
素材写真	そざいしゃしん	マーケティング
広告	こうこく	マーケティング
口コミ	くちこみ	マーケティング
レビュー	れびゅー	マーケティング
改修	かいしゅう	マーケティング
解析フロー	かいせきふろー	マーケティング
会場費	かいじょうひ	マーケティング
会員制アプリ	かいいんせいあぷり	マーケティング
会員限定コンテンツ	かいいんげんていこんてんつ	マーケティング
課金	かきん	マーケティング
加味	かみ	マーケティング
仮説	かせつ	マーケティング
下書き	したがき	マーケティング
運用保守	うんようほしゅ	マーケティング
運用代行	うんようだいこう	マーケティング
運用フロー	うんようふろー	マーケティング
運用	うんよう	マーケティング
ローンチ	ろーんち	マーケティング
ロードマップ	ろーどまっぷ	マーケティング
外部ライター	がいぶらいたー	マーケティング
関連キーワード	かんれんきーわーど	マーケティング
企画	きかく	マーケティング
効果検証	こうかけんしょう	マーケティング
効能	こうのう	マーケティング
検証	けんしょう	マーケティング
検索ボリューム	けんさくぼりゅーむ	マーケティング
検索クエリ	けんさくくえり	マーケティング
検索キーワード	けんさくきーわーど	マーケティング
検索エンジン	けんさくえんじん	マーケティング
決済代行	けっさいだいこう	マーケティング
決済額	けっさいがく	マーケティング
決済システム	けっさいしすてむ	マーケティング
企業情報	きぎょうじょうほう	マーケティング
既存顧客	きぞんこきゃく	マーケティング
機会損失	きかいそんしつ	マーケティング
継続課金	けいぞくかきん	マーケティング
継続的接触	けいぞくてきせっしょく	マーケティング
計測	けいそく	マーケティング
コミッター	こみったー	WordPress
カバーブロック	かばーぶろっく	WordPress
コードエディター	こーどえでぃたー	WordPress
コアコミッター	こあこみったー	WordPress
コア	こあ	WordPress
グループブロック	ぐるーぷぶろっく	WordPress
カラム数	からむすう	WordPress
カラムブロック	からむぶろっく	WordPress
コントリビューター	こんとりびゅーたー	WordPress
コントリビューターデイ	こんとりびゅーたーでい	WordPress
テンプレートタグ	てんぷれーとたぐ	WordPress
テーマ	てーま	WordPress
ダイナミックブロック	だいなみっくぶろっく	WordPress
要素セレクタ	ようそせれくた	WordPress
セッションリスト	せっしょんりすと	WordPress
セッションデイ	せっしょんでい	WordPress
セッション	せっしょん	WordPress
ショートコード	しょーとこーど	WordPress
サポートフォーラム	さぽーとふぉーらむ	WordPress
コントリビュート	こんとりびゅーと	WordPress
カスタム投稿タイプ	かすたむとうこうたいぷ	WordPress
カスタムリンク	かすたむりんく	WordPress
wp-env	だぶりゅぴーえんぶ	WordPress
WordPressフォーラム	わーどぷれすふぉーらむ	WordPress
WordPress.org	わーどぷれすどっとおるぐ	WordPress
WordPress.com	わーどぷれすどっとこむ	WordPress
WordPress Meetup	わーどぷれすみーとあっぷ	WordPress
WordPress	わーどぷれす	WordPress
WordCamp	わーどきゃんぷ	WordPress
Webアセンブラー	うぇぶあせんぶらー	WordPress
Twenty Twenty One	とぅうぇんてぃとぅうぇんてぃわん	WordPress
wp-env	だぶるぴーえんぶ	WordPress
WP_Query	だぶりゅぴーくえりー	WordPress
カスタムフィールド製造業	かすたむふぃーるどせいぞうぎょう	WordPress
カスタムHTML	かすたむえいちてぃーえむえる	WordPress
カスタマイザー	かすたまいざー	WordPress
インスペクター	いんすぺくたー	WordPress
インサーター	いんさーたー	WordPress
アイキャッチ	あいきゃっち	WordPress
WP.com	だぶりゅぴーどっとこむ	WordPress
wp_register_script	だぶりゅぴーれじすたーすくりぷと	WordPress
WP_Query	だぶるぴーくえりー	WordPress
Twenty Twenty	とぅうぇんてぃとぅうぇんてぃ	WordPress
バグレポート	ばぐれぽーと	WordPress
ボタンブロック	ぼたんぶろっく	WordPress
引用ブロック	いんようぶろっく	WordPress
画像ブロック	がぞうぶろっく	WordPress
管理バー	かんりばー	WordPress
管理画面機能	かんりがめんきのう	WordPress
共同オーガナイザー	きょうどうおーがないざー	WordPress
共同創始者	きょうどうそうししゃ	WordPress
共同編集	きょうどうへんしゅう	WordPress
見出しブロック	みだしぶろっく	WordPress
公開ボタン	こうかいぼたん	WordPress
リリース予定	りりーすよてい	WordPress
リビジョン	りびじょん	WordPress
マイナーアップデート	まいなーあっぷでーと	WordPress
ブロック追加ボタン	ぶろっくついかぼたん	WordPress
メジャーアップデート	めじゃーあっぷでーと	WordPress
メディアとテキストブロック	めでぃあとてきすとぶろっく	WordPress
メディアと文章	めでぃあとぶんしょう	WordPress
ライブプレビュー	らいぶぷれびゅー	WordPress
リカバリー	りかばりー	WordPress
リストブロック	りすとぶろっく	WordPress
リッチメディア	りっちめでぃあ	WordPress
構造化データ	こうぞうかでーた	WordPress
再利用ブロック	さいりようぶろっく	WordPress
ブロックフィルター	ぶろっくふぃるたー	WordPress
ブロックフィルター	ぶろっくふぃるた	WordPress
ブロックパターン	ぶろっくぱたーん	WordPress
ブロックナビゲーション	ぶろっくなびげーしょん	WordPress
ブロックツールバー	ぶろっくつーるばー	WordPress
ブロックテンプレート	ぶろっくてんぷれーと	WordPress
ブロックエディター	ぶろっくえでぃたー	WordPress
ブロックエディター	ぶろっくえでぃた	WordPress
プラグイン	ぷらぐいん	WordPress
ブロックマネージャー	ぶろっくまねーじゃ	WordPress
ブロックマネージャー	ぶろっくまねーじゃー	WordPress
段落ブロック	だんらくぶろっく	WordPress
中見出し	ちゅうみだし	WordPress
通常ブロック	つうじょうぶろっく	WordPress
入力画面	にゅうりょくがめん	WordPress
文章ブロック	ぶんしょうぶろっく	WordPress
編集画面	へんしゅうがめん	WordPress
埋め込み系ブロック	うめこみけいぶろっく	WordPress
有効化	ゆうこうか	WordPress
ブロックライブラリ	ぶろっくらいぶらり	WordPress
ビジュアル編集	びじゅあるへんしゅう	WordPress
Twenty Nineteen	とぅうぇんてぃないんてぃーん	WordPress
Trac	とらっく	WordPress
Gutenberg	ぐーてんべるく	WordPress
Block Filters	ぶろっくふぃるたーず	WordPress
Block Editor Handbook	ぶろっくえでぃたーはんどぶっく	WordPress
Author	おうさー	WordPress
alignfull	あらいんふる	WordPress
add_action	あっどあくしょん	WordPress
100%GPL	ひゃくぱーせんとじーぴーえる	WordPress
ツールバー	つーるばー	WordPress
Gutenberg	ぐーてんべるぐ	WordPress
HTMLとして編集	えいちてぃーえむえるとしてへんしゅう	WordPress
HTMLとして編集	えっちてぃーえむえるとしてへんしゅう	WordPress
register_block_type	れじすたーぶろっくたいぷ	WordPress
State of the Word	すてーとおぶざわーど	WordPress
Publishing	ぱぶりっしんぐ	WordPress
post_content	ぽすとこんてんと	WordPress
Post	ぽすと	WordPress
Page	ぺーじ	WordPress
Meta Description	めたですくりぷしょん	WordPress
Making WordPress	めいきんぐわーどぷれす	WordPress
Make WordPress	めいくわーどぷれす	WordPress
Googleトレンド	ぐーぐるとれんど	サービス
Googleフォーム	ぐーぐるふぉーむ	サービス
Zapier	ざぴあー	サービス
ロリポップ！	ろりぽっぷ	サービス
モリサワ	もりさわ	サービス
さくらインターネット	さくらいんたーねっと	サービス
グラバター	ぐらばたー	サービス
エックスサーバー	えっくすさーばー	サービス
Googleカレンダー	ぐーぐるかれんだー	サービス
Google マイビジネス	ぐーぐるまいびじねす	サービス
Google Tag Manager	ぐーぐるたぐまねーじゃー	サービス
Googleマップ	ぐーぐるまっぷ	サービス
Adobe	あどび	サービス
Ahrefs	えーえいちれふす	サービス
Facebook	ふぇいすぶっく	サービス
FontAwesome	ふぉんとおーさむ	サービス
GitHub	ぎっとはぶ	サービス
GMOペパボ	じーえむおーぺぱぼ	サービス
Google	ぐーぐる	サービス
Google Analytics	ぐーぐるあなりてぃくす	サービス
Google Search Console	ぐーぐるさーちこんそーる	サービス
Googleフォント	ぐーぐるふぉんと	サービス
いらすとや	いらすとや	サービス
heteml	へてむる	サービス
Slack	すらっく	サービス
Shopify	しょっぴふぁい	サービス
Shifter	しふたー	サービス
Sendgrid	せんどぐりっど	サービス
reCaptcha	りきゃぷちゃ	サービス
po editor	ぴーおーえでぃたー	サービス
PayPal	ぺいぱる	サービス
Mautic	まうてぃっく	サービス
LinkedIn	りんくといん	サービス
LINE	らいん	サービス
Instagram	いんすたぐらむ	サービス
HubSpot	はぶすぽっと	サービス
Gメール	じーめーる	サービス
Stripe	すとらいぷ	サービス
Wechat	うぃーちゃっと	サービス
YouTube	ゆーちゅーぶ	サービス
Whatsapp	ほわっつあっぷ	サービス
Welcart	うぇるかーと	サービス
WP Tavern	だぶるぴーたばーん	サービス
TypeSquare	たいぷすくえあ	サービス
Sli.do	すらいどぅー	サービス
Twitter	ついったー	サービス
Nishiki	にしき	テーマ
LIQUID PRESS	りきっどぷれす	テーマ
Katawara	かたわら	テーマ
SWELL	すうぇる	テーマ
Arkhe	あるけー	テーマ
Snow Monkey	すのーもんきー	テーマ
Lightning	らいとにんぐ	テーマ
Site Kit by Google	さいときっとばいぐーぐる	プラグイン
SiteGuard WP Plugin	さいとがーど	プラグイン
Snow Monkey Blocks	すのーもんきーぶろっくす	プラグイン
Snow Monkey Editor	すのーもんきーえでぃたー	プラグイン
Snow Monkey Forms	すのーもんきーふぉーむず	プラグイン
UpdraftPlus	あっぷどらふとぷらす	プラグイン
Public Post Preview	ぱぶりっくぽすとぷれびゅー	プラグイン
Simple Post Type Permalinks	しんぷるぽすとたいぷぱーまりんくす	プラグイン
Simple Map	しんぷるまっぷ	プラグイン
Pubsubhubbub	ぱぶさぶはぶばぶ	プラグイン
qTranslate X	きゅーとらんすれいとえっくす	プラグイン
Restricted Block by User Roles	りすとりくてっどぶろっく	プラグイン
Restricted Block by User Roles	りすとりくてっどぶろっくばいゆーざーろーる	プラグイン
SEO SIMPLE PACK	えすいーおーしんぷるぱっく	プラグイン
Show Current Template	しょうかれんとてんぷれーと	プラグイン
Simple Definition List Blocks	しんぷるでぃふぃにしょんりすとぶろっくす	プラグイン
Simple GA Ranking Plugin	しんぷるじーえーらんきんぐぷらぐいん	プラグイン
Useful Blocks	ゆーすふるぶろっくす	プラグイン
VK Block Pattern Plugin Generator	ぶいけーぶろっくぱたーんぷらぐいんじぇねれーたー	プラグイン
VK Block Patterns	ぶいけーぶろっくぱたーんず	プラグイン
WP Revisions Control	だぶりゅぴーりびじょんずこんとろーる	プラグイン
WP Revisions Control	だぶるぴーりびじょんこんとろーる	プラグイン
WP Revisions Control	だぶるぴーりびじょんずこんとろーる	プラグイン
WP Revisions Control	りびじょんこんとろーる	プラグイン
WP Revisions Control	りびじょんずこんとろーる	プラグイン
WPML	だぶるぴーえむえる	プラグイン
XO Security	えっくすおーせきゅりてぃ	プラグイン
Yoast Duplicate Post	でゅぷりけーとぽすと	プラグイン
WP Revisions Control	だぶりゅぴーりびじょんこんとろーる	プラグイン
WP Post Has Archive	だぶるぴーぽすとはずあーかいぶ	プラグイン
VK Blocks	ぶいけーぶろっくす	プラグイン
VK Filter Search	ぶいけーふぃるたーさーち	プラグイン
VK Link Target Controller	ぶいけーりんくたーげっとこんとろーらー	プラグイン
WEGLOT	うぃぐろっと	プラグイン
WooCommerce	うーこまーす	プラグイン
Wordfence Security - Firewall & Malware Scan	わーどふぇんす	プラグイン
WP Maintenance Mode	だぶるぴーめんてなんすもーど	プラグイン
WP Mautic	だぶるぴーまうてぃっく	プラグイン
Site Kit by Google	さいときっと	プラグイン
PPPP	ぴーぴーぴーぴー	プラグイン
Yoast Duplicate Post	よーすとでゅぷりけーとぽすと	プラグイン
BBQ Firewall	びーびーきゅーふぁいあーうぉーる	プラグイン
BOGO	ぼご	プラグイン
Broken Link Checker	ぶろーくんりんくちぇっかー	プラグイン
Classic Editor	くらしっくえでぃた	プラグイン
Classic Editor	くらしっくえでぃたー	プラグイン
Contact Form 7	こんたくとふぉーむせぶん	プラグイン
Contact Form 7 Serial Numbers	こんたくとふぉーむせぶんしりあるなんばーず	プラグイン
Custom Block Patterns	かすたむぶろっくぱたーんず	プラグイン
Custom Post Type Permalinks	かすたむぽすとたいぷぱーまりんくす	プラグイン
Custom Post Type UI	かすたむぽすとたいぷゆーあい	プラグイン
Disable Comments	でぃすえいぶるこめんつ	プラグイン
BackWPup - WordPress Backup Plugin	ばっくだぶるぴーあっぷ	プラグイン
BackWPup - WordPress Backup Plugin	ばっくだぶりゅぴーあっぷ	プラグイン
All in One WP Security	おーるいんわんだぶるぴーせきゅりてぃ	プラグイン
ACF	えーしーえふ	プラグイン
Admin Bar Position	あどみんばーぽじしょん	プラグイン
Advanced Automatic Updates	あどばんすとおーとまてぃっくあっぷでーつ	プラグイン
Advanced Custom Field	あどばんすどかすたむふぃーるど	プラグイン
Advanced Posts Blocks	あどばんすどぽすつぶろっくす	プラグイン
Advanced Posts Blocks	あどばんすどぽすとぶろっくす	プラグイン
All in One SEO Pack	おーるいんわんえすいーおー	プラグイン
All in One SEO Pack	おーるいんわんえすいーおーぱっく	プラグイン
All in One WP Migration	おーるいんわんだぶりゅぴーまいぐれーしょん	プラグイン
All in One WP Migration	おーるいんわんだぶるぴーまいぐれーしょん	プラグイン
All in One WP Security	おーるいんわんだぶりゅぴーせきゅりてぃ	プラグイン
Disable Comments	でぃすえいぶるこめんと	プラグイン
Disable Emojis (GDPR friendly)	でぃすえいぶるえもじ	プラグイン
LIQUID BLOCKS GALLERY	りきっどぶろっくぎゃらりー	プラグイン
LIQUID SPEECH BALOON	りきっどすぴーちばるーん	プラグイン
Easy WP Meta Description	いーじーだぶりゅぴーめたですくりぷしょん	プラグイン
Lorem Ipsum Blocks	ろーれむいぷさむぶろっくす	プラグイン
Lorem Ipsum Blocks	ろーれんいぷさむぶろっくす	プラグイン
Multi Language Switcher	まるちらんげーじすいっちゃー	プラグイン
MultilingualPress	まるちりんがるぷれす	プラグイン
My Calendar	まいかれんだー	プラグイン
Per page head	ぱーぺーじへっど	プラグイン
Plugins Condition	ぷらぐいんずこんでぃしょん	プラグイン
Polylang	ぽりらんぐ	プラグイン
Lazy Blocks	れいじーぶろっくす	プラグイン
Jetpack	じぇっとぱっく	プラグイン
Intuitive Custom Post Order	いんちゅいてぃぶかすたむぽすとおーだー	プラグイン
Disable Emojis (GDPR friendly)	でぃすえいぶるえもじず	プラグイン
Easy Access Reusable Blocks	いーじーあくせすりゆーざぶるぶろっくす	プラグイン
Editor Block Outline	えでぃたーぶろっくあうとらいん	プラグイン
Elementor	えれめんたー	プラグイン
Enable Media Replace	えねいぶるめでぃありぷれいす	プラグイン
ExUnit	いーえっくすゆにっと	プラグイン
Flamingo	ふらみんご	プラグイン
Ghost Kit	ごーすときっと	プラグイン
Google XML Sitemaps	ぐーぐるえっくすえむえるさいとまっぷす	プラグイン
Highlighting Code Block	はいらいてぃんぐこーどぶろっく	プラグイン
Instagram Feed	いんすたぐらむふぃーど	プラグイン
Powerful Posts Per Page	ぱわふるぽすつぱーぺーじ	プラグイン
Yoast SEO	よーすとえすいーおー	プラグイン
Cloud Firestore	くらうどふぁいあーすとあ	プロダクト
Drupal	どるーぱる	プロダクト
Drupal	どぅるーぱる	プロダクト
EC Cube	いーしーきゅーぶ	プロダクト
FaaS	ふぁーす	プロダクト
Figma	ふぃぐま	プロダクト
Firebase	ふぁいあーべーす	プロダクト
Gatsby	ぎゃつびー	プロダクト
GraphCMS	ぐらふしーえむえす	プロダクト
Gridsome	ぐりっどさむ	プロダクト
Dropbox Paper	どろっぷぼっくすぺーぱー	プロダクト
Dropbox	どろっぷぼっくす	プロダクト
Backlog	ばっくろぐ	プロダクト
Android	あんどろいど	プロダクト
AMP	あんぷ	プロダクト
Algoria	あるごりあ	プロダクト
Angular	あんぎゅらー	プロダクト
Alexa	あれくさ	プロダクト
Apache	あぱっち	プロダクト
App	あっぷ	プロダクト
ASP	えーえすぴー	プロダクト
Auth0	おーすぜろ	プロダクト
AWS	えーだぶりゅえす	プロダクト
GUI	じーゆーあい	プロダクト
GUI	ぐい	プロダクト
Nuxt.js	なくすとじぇいえす	プロダクト
Vue.js	びゅーじぇいえす	プロダクト
Reactライブラリ	りあくとらいぶらり	プロダクト
React Native	りあくとねいてぃぶ	プロダクト
Nuxt	なくすと	プロダクト
OpenSSL	おーぷんえすえすえる	プロダクト
oVice	おーびす	プロダクト
PHP	ぴーえいちぴー	プロダクト
Raspberry Pi	らずべりーぱい	プロダクト
npm	えぬぴーえむ	プロダクト
Next.js	ねくすとじぇいえす	プロダクト
microCMS	まいくろしーえむえす	プロダクト
Ionic	あいおにっく	プロダクト
iOS	あいおーえす	プロダクト
Joomla	じゅーむら	プロダクト
Mac	まっく	プロダクト
WP API	だぶるぴーえーぴーあい	プロダクト
MovableType	むーばぶるたいぷ	プロダクト
MySQL	まいえすきゅーえる	プロダクト
React	りあくと	プロダクト
インターナショナリゼーション	いんたーなしょなりぜーしょん	Web用語
Serverless	さーばーれす	Web用語
キーボード	きーぼーど	Web用語
エラー	えらー	Web用語
yarn start	やーんすたーと	Web用語
コピペ	こぴぺ	Web用語
ガチ勢	がちぜい	Web用語
カスケーディングスタイルシート	かすけーでぃんぐすたいるしーと	Web用語
ガジェット	がじぇっと	Web用語
カイゼン	かいぜん	Web用語
カード情報	かーどじょうほう	Web用語
カート	かーと	Web用語
オフライン	おふらいん	Web用語
オープンソース	おーぷんそーす	Web用語
カラム	からむ	Web用語
カルーセル	かるーせる	Web用語
キャッシュ	きゃっしゅ	Web用語
コーディング	こーでぃんぐ	Web用語
クローン	くろーん	Web用語
クラウド翻訳	くらうどほんやく	Web用語
クラウドファンディング	くらうどふぁんでぃんぐ	Web用語
クラウド	くらうど	Web用語
ググる	ぐぐる	Web用語
クオリティチェック	くおりてぃちぇっく	Web用語
キャプション	きゃぷしょん	Web用語
オーバーレイ	おーばーれい	Web用語
オウンドメディアサイト	おうんどめでぃあさいと	Web用語
オウンドメディア	おふんどめでぃあ	Web用語
アンカー	あんかー	Web用語
アプリ	あぷり	Web用語
アプデ	あぷで	Web用語
アフィリエイト	あふぃりえいと	Web用語
アップデート	あっぷでーと	Web用語
アイコン	あいこん	Web用語
アーカイブ	あーかいぶ	Web用語
zip	じっぷ	Web用語
インターナショナライゼーション	いんたーなしょならいぜーしょん	Web用語
インライン画像	いんらいんがぞう	Web用語
ウィジェット	うぃじぇっと	Web用語
エラー文	えらーぶん	Web用語
エラー修正	えらーしゅうせい	Web用語
エラー回避	えらーかいひ	Web用語
エラーメッセージ	えらーめっせーじ	Web用語
エスケープ文字	えすけーぷもじ	Web用語
エクステンション	えくすてんしょん	Web用語
ウェブページ	うぇぶぺーじ	Web用語
ウェブサービス	うぇぶさーびす	Web用語
ドラック&ドロップ	どらっくあんどどろっぷ	Web用語
yarn build	やーんびるど	Web用語
jQuery	じぇいくえりー	Web用語
http	えいちてぃーてぃーぴー	Web用語
HTML	えっちてぃーえむえる	Web用語
HTML	えいちてぃーえむえる	Web用語
hreflang	えいちれふらんぐ	Web用語
href	えいちれふ	Web用語
Hello World!	はろーわーるど	Web用語
Headless CMS	へっどれすしーえむえす	Web用語
GraphQL	ぐらふきゅーえる	Web用語
GPL	じーぴーえる	Web用語
HTTP API	えいちてぃーてぃーぴーえーぴーあい	Web用語
HTTP Client	えいちてぃーてぃーぴーくらいあんと	Web用語
JavaScript	じゃばすくりぷと	Web用語
JAMStack	じゃむすたっく	Web用語
ja	じぇいえー	Web用語
IT	あいてぃー	Web用語
issue	いしゅー	Web用語
iframe	あいふれーむ	Web用語
i18n	あいいちはちえぬ	Web用語
https化	えいちてぃーてぃーぴーえすか	Web用語
https	えいちてぃーてぃーぴーえす	Web用語
Git	ぎっと	Web用語
Gifアニメ	じふあにめ	Web用語
GB	ぎがばいと	Web用語
Cron	くろん	Web用語
Cron	くーろん	Web用語
CMS	しーえむえす	Web用語
CJK	しーじぇーけー	Web用語
CDN	しーでぃーえぬ	Web用語
API	えーぴーあい	Web用語
A/Bテスト	えーびーてすと	Web用語
_e	あんだーばーいー	Web用語
__	あんだーばーあんだーばー	Web用語
CSS	しーえすえす	Web用語
CSV	しーえすぶい	Web用語
FTP	えふてぃーぴー	Web用語
Flash	ふらっしゅ	Web用語
ffmpeg	えふえふえむぺぐ	Web用語
EC	いーしー	Web用語
DTP	でぃーてぃーぴー	Web用語
Description	でぃすくりぷしょん	Web用語
Description	ですくりぷしょん	Web用語
CVR	しーぶいあーる	Web用語
CTA	しーてぃーえー	Web用語
yarn	やーん	Web用語
jQuery	じぇーくえりー	Web用語
Gif	じふ	Web用語
View	びゅー	Web用語
UX	ゆーえっくす	Web用語
URL	ゆーあーるえる	Web用語
UI	ゆーあい	Web用語
TB	てらばいと	Web用語
Static Site Generator	すたてぃっくさいとじぇねれーたー	Web用語
SSL	えすえすえる	Web用語
SQL	えすきゅーえる	Web用語
SPA	えすぴーえー	Web用語
WAF	わふ	Web用語
Web API	うぇぶえーぴーあい	Web用語
Wi-Fi環境	わいふぁいかんきょう	Web用語
Wi-Fi	わいふぁい	Web用語
Webメディア	うぇぶめでぃあ	Web用語
Webマーケティング	うぇぶまーけてぃんぐ	Web用語
Webページ	うぇぶぺーじ	Web用語
Webサイト	うぇぶさいと	Web用語
Webアプリケーション	うぇぶあぷりけーしょん	Web用語
WebP	うぇぶぴー	Web用語
WebP	うぇっぴー	Web用語
SNS	えすえぬえす	Web用語
Single Page Application	しんぐるぺーじあぷりけーしょん	Web用語
SDGs	えすでぃーじーず	Web用語
npm run build	えぬぴーらんびるど	Web用語
npm install	えぬぴーえむいんすとーる	Web用語
Meetup	みーとあっぷ	Web用語
MB	めがばいと	Web用語
LT	えるてぃー	Web用語
LP	えるぴー	Web用語
L10N	えるいちぜろえぬ	Web用語
KGI	けーじーあい	Web用語
JSON	じぇいそん	Web用語
OSS	おーえすえす	Web用語
PDF	ぴーでぃーえふ	Web用語
SaaS	さーす	Web用語
RSS	あーるえすえす	Web用語
RichText	りっちてきすと	Web用語
REST API	れすとえーぴーあい	Web用語
REST	れすと	Web用語
rel	れる	Web用語
PWA	ぴーだぶりゅえー	Web用語
Progressive Web Application	ぷろぐれっしぶうぇぶあぷりけーしょん	Web用語
PDO	ぴーでぃーおー	Web用語
JS	じぇーえす	Web用語
見出し	みだし	Web用語
音声	おんせい	Web用語
ワイヤーフレーム	わいやーふれーむ	Web用語
ログイン攻撃	ろぐいんこうげき	Web用語
ローカリゼーション	ろーかりぜーしょん	Web用語
ローカライゼーション	ろーからいぜーしょん	Web用語
レイヤー	れいやー	Web用語
レイアウト	れいあうと	Web用語
リンク	りんく	Web用語
リプライ	りぷらい	Web用語
解像度	かいぞうど	Web用語
開発言語	かいはつげんご	Web用語
階層	かいそう	Web用語
景表法	けいひょうほう	Web用語
共有ボタン	きょうゆうぼたん	Web用語
挙動	きょどう	Web用語
機能	きのう	Web用語
機械翻訳	きかいほんやく	Web用語
基幹	きかん	Web用語
活版印刷	かっぱんいんさつ	Web用語
外部配信	がいぶはいしん	Web用語
外部サービス認証	がいぶさーびすにんしょう	Web用語
リアルタイム	りあるたいむ	Web用語
ライセンス	らいせんす	Web用語
マネージドサービス	まねーじどさーびす	Web用語
マスメディア	ますめでぃあ	Web用語
マシンパワー	ましんぱわー	Web用語
マサカリ	まさかり	Web用語
マイルストーン	まいるすとーん	Web用語
マージ	まーじ	Web用語
マークダウン	まーくだうん	Web用語
マークアップ	まーくあっぷ	Web用語
ポモドーロテクニック	ぽもどーろてくにっく	Web用語
マルチプラットフォーム	まるちぷらっとふぉーむ	Web用語
ミドルウェア	みどるうぇあ	Web用語
メディア	めでぃあ	Web用語
ユースケース	ゆーすけーす	Web用語
ユーザエージェント	ゆーざーえーじぇんと	Web用語
ユーザー層	ゆーざーそう	Web用語
ユーザー管理	ゆーざーかんり	Web用語
ユーザー	ゆーざー	Web用語
モバイルアプリ	もばいるあぷり	Web用語
モバイル	もばいる	Web用語
メンテナンス	めんてなんす	Web用語
メンテ	めんて	Web用語
ホバー	ほばー	Web用語
翻訳	ほんやく	Web用語
大見出し	おおみだし	Web用語
代替案	だいたいあん	Web用語
代替案	だいがえあん	Web用語
代替	だいたい	Web用語
代替	だいがえ	Web用語
対象	たいしょう	Web用語
多言語化	たげんごか	Web用語
多言語サイト	たげんごさいと	Web用語
設定項目	せっていこうもく	Web用語
端末	たんまつ	Web用語
動的	どうてき	Web用語
認証	にんしょう	Web用語
変数	へんすう	Web用語
頻度	ひんど	Web用語
描画	びょうが	Web用語
非公開領域	ひこうかいりょういき	Web用語
非公開情報	ひこうかいじょうほう	Web用語
配置	はいち	Web用語
破壊的変更	はかいてきへんこう	Web用語
認証処理	にんしょうしょり	Web用語
認証系	にんしょうけい	Web用語
脆弱性	ぜいじゃくせい	Web用語
静的化	せいてきか	Web用語
修正版	しゅうせいばん	Web用語
受託制作会社	じゅたくせいさくがいしゃ	Web用語
受託制作	じゅたくせいさく	Web用語
実装	じっそう	Web用語
仕様	しよう	Web用語
再掲	さいけい	Web用語
行間	ぎょうかん	Web用語
構成	こうせい	Web用語
恒久的	こうきゅうてき	Web用語
縦積み	たてづみ	Web用語
出力画面	しゅつりょくがめん	Web用語
初学者	しょがくしゃ	Web用語
生成処理	せいせいしょり	Web用語
生成	せいせい	Web用語
生産性	せいさんせい	Web用語
制作者	せいさくしゃ	Web用語
制作	せいさく	Web用語
推奨	すいしょう	Web用語
図版	ずはん	Web用語
障害	しょうがい	Web用語
小見出し	こみだし	Web用語
互換性	ごかんせい	Web用語
トップページ	とっぷぺーじ	Web用語
タップ	たっぷ	Web用語
タスク	たすく	Web用語
タイムアウト	たいむあうと	Web用語
タイトルタグ	たいとるたぐ	Web用語
ターゲット	たーげっと	Web用語
ソーシャルリンクメニュー	そーしゃるりんくめにゅー	Web用語
センタリング	せんたりんぐ	Web用語
センサー	せんさー	Web用語
セッションタイムアウト	せっしょんたいむあうと	Web用語
チェックリスト	ちぇっくりすと	Web用語
チャット	ちゃっと	Web用語
チュートリアル	ちゅーとりある	Web用語
デプロイ	でぷろい	Web用語
テストページ	てすとぺーじ	Web用語
テスト	てすと	Web用語
デザイン	でざいん	Web用語
デザイナー	でざいなー	Web用語
テキスト	てきすと	Web用語
データベース	でーたべーす	Web用語
データソース	でーたそーす	Web用語
ディレクトリ	でぃれくとり	Web用語
セクション	せくしょん	Web用語
スライド	すらいど	Web用語
サイトマップ	さいとまっぷ	Web用語
サイドバー	さいどばー	Web用語
サイト	さいと	Web用語
サーバーレス	さーばーれす	Web用語
サーバーサイド	さーばーさいど	Web用語
コンポーネント	こんぽーねんと	Web用語
コンテンツエリア	こんてんつえりあ	Web用語
コンテキスト	こんてきすと	Web用語
コンサル	こんさる	Web用語
サブディレクトリ	さぶでぃれくとり	Web用語
サブドメイン	さぶどめいん	Web用語
シングルサインオン	しんぐるさいんおん	Web用語
スライダー	すらいだー	Web用語
スマホ入力	すまほにゅうりょく	Web用語
スマホ	すまほ	Web用語
スパム	すぱむ	Web用語
ストレージ	すとれーじ	Web用語
ステータスメッセージ	すてーたすめっせーじ	Web用語
ステークホルダー	すてーくほるだー	Web用語
スケーリング	すけーりんぐ	Web用語
スクショ	すくしょ	Web用語
コラボレーション機能	こらぼれーしょんきのう	Web用語
ホスティング	ほすてぃんぐ	Web用語
ブロガー	ぶろがー	Web用語
フルパス	ふるぱす	Web用語
フリーランス	ふりーらんす	Web用語
プライバシーポリシー	ぷらいばしーぽりしー	Web用語
フッター	ふったー	Web用語
フッター	ふった	Web用語
プッシュ通知	ぷっしゅつうち	Web用語
フック	ふっく	Web用語
フォーム	ふぉーむ	Web用語
ブログ	ぶろぐ	Web用語
プロジェクト	プロジェクト	Web用語
プロセス	ぷろせす	Web用語
ポートフォリオ	ぽーとふぉりお	Web用語
ベンダー	べんだー	Web用語
ヘッダー	へっだー	Web用語
ヘッダー	へっだ	Web用語
ページタイトル	ぺーじたいとる	Web用語
フロントエンド	ふろんとえんど	Web用語
プロトタイピング	ぷろとたいぴんぐ	Web用語
ブロック	ぶろっく	Web用語
プロダクト	ぷろだくと	Web用語
フィルタ	ふぃるた	Web用語
フィグキャプション	ふぃぐきゃぷしょん	Web用語
パクリ	ぱくり	Web用語
バグってる	ばぐってる	Web用語
バグ	ばぐ	Web用語
パーマリンク	ぱーまりんく	Web用語
ハードウェア	はーどうぇあ	Web用語
ナビゲーション	なびげーしょん	Web用語
トンマナ	とんまな	Web用語
ドロップキャプス	どろっぷきゃぷす	Web用語
ドロップキャップ	どろっぷきゃっぷ	Web用語
バグる	ばぐる	Web用語
パクる	ぱくる	Web用語
バナー	ばなー	Web用語
フィギュキャプション	ふぃぎゅきゃぷしょん	Web用語
フィギュア	ふぃぎゅあ	Web用語
フィードバック	ふぃーどばっく	Web用語
ビルド	びるど	Web用語
ビジュアルデザイン	びじゅあるでざいん	Web用語
パンくずリスト	ぱんくずりすと	Web用語
パララックス	ぱららっくす	Web用語
パラメータ	ぱらめーた	Web用語
パフォーマンス	ぱふぉーまんす	Web用語
トリミング	とりみんぐ	Web用語